11111111111111111111
100000001E1000000001
1000Q0001Q1000000001
100Q0Q001010000P0001
1000C000101000Q00001
100Q0Q00000000000001
1000Q000101000W00001
10000000101000000001
10000000101000000001
11111111111111111111
