111111111
100000001
100000001
1000C0001
1000P0001
1000E0001
100000001
100000001
111111111
