1111111111111111111
1000000000C000000E1
1000100000000010001
1000100111111011001
10001C0C0C0C0001001
10001C0C0C0C0001001
10001C0C0C0C0001001
10001C0C0C0C0001001
10001C0C0P0C0001011
10001C0C0C0C0001001
10000C0C0C0C00000E1
1111111111111111111
