11111111111111111
10000000000000001
10000000000000001
1111100Q000111111
10000000000000001
10000000000000001
10000000111100001
1000000010E100001
10000000101100001
10000000000000001
10000000000000001
10000010111000001
100000101P1000001
10000010001000001
10000011111000001
10000000000000001
10000000000000001
10000000000000001
10000000000000001
1000000C000000001
10000000000000001
11111111111111111
