1111111111111111111
1000000000C00000001
1000100000000010001
1000100111111011001
1000100000000001001
1000100000000001001
1000100000000001001
1000100000000001001
100010000P000001011
1000100000000001001
10000000000000000E1
1111111111111111111
