1111111111111111111111111111111111
1E00000000000000000000000000000001
1010010100100000101001000000010101
10100101001001001Q1001000000010101
1010010100100100101001000000010101
10100101001000001010010000Q0010101
1010010100100000101001000000010101
1010010100100000101001000000010101
1010010010101010001001000000010101
1P000000000000000000000000000000C1
1111111111111111111111111111111111
