111111111111111111111111111111111111111111111111111111111111111111111111
10000000000000000000000000000000000000000000000000000E000000000000000001
10000000000111000000000000000000000000000000000000000C000000000000000001
100000000001Q1000000000000000000000000000000000000000P000000000000000001
100000000001010000000000000000000000000000000000000000000000000000000001
100000000000000000000000000000000000000000000000000000000000000000000001
111111111111111111111111111111111111111111111111111111111111111111111111
